112222110000022
000001221001111
110000110000002
000111000000002
000011100000002
000000000000002
110000000000002
211110200200002
221113320200002
222211332222222
